11111111111111111111111111111
1P000000000000000000000000011
1C000000000000000000000000011
11111111111111111111111111111