11111111111111111111111111111
1P0000000000000000000C00E0011
1000000000000C000000000000011
11111111111111111111111111111