11111111111111111111111111111
1P0000000000000000000C0000011
1000000000000C001010000E00011
11111111111111111111111111111