111111111111111111111111111111111111111111111111111111111111
100000000000000000000000000000000000000000000000000000000001
10001111100000000000000000000000000000000P000000000000000011
100010000000000000000000000000000000000000000000000000000001
100011110000000000000000000000000000000000000000000000000011
1000E0000000000000000000000000000000000000000000000000000001
111111111111111111111111111111111111111111111111111111111111