11111111111111111111111111111
100000000000000000000C0000011
1000000000P00C001010001E00011
11111111111111111111111111111